▓▓▓▓▓▓▓▓▓▓▓▓▓▓▓▓▓▓▓▓▓▓▓▓▓▓▓▓▓▓▓▓▓▓▓▓▓▓▓▓▓▓▓▓▓▓▓▓▓▓▓▓▓▓▓▓▓▓▓▓▓▓▓▓▓▓▓▓▓▓▓▓▓▓
▓  ####################################################################  ▓
▓  ####################################################################  ▓
▓  ####################################################################  ▓
▓  ####################################################################  ▓      Score: 0
▓  ####################################################################  ▓
▓  ####################################################################  ▓
▓  ####################################################################  ▓
▓  ####################################################################  ▓
▓  ####################################################################  ▓
▓  ####################################################################  ▓
▓                                                                        ▓
▓                                                                        ▓
▓                                                                        ▓
▓                                                                        ▓
▓                                                                        ▓
▓                                                                        ▓
▓                                                                        ▓
▓                                                                        ▓
▓                                                                        ▓
▓                                                                        ▓
▓                                    @                                   ▓
▓                                                                        ▓
▓                                                                        ▓
▓                            █████████████████                           ▓
▓                                                                        ▓
▓                                                                        ▓
▓▓▓▓▓▓▓▓▓▓▓▓▓▓▓▓▓▓▓▓▓▓▓▓▓▓▓▓▓▓▓▓▓▓▓▓▓▓▓▓▓▓▓▓▓▓▓▓▓▓▓▓▓▓▓▓▓▓▓▓▓▓▓▓▓▓▓▓▓▓▓▓▓▓